##################################################
##################################################
#................................................#
#................................................#
#............##################..................#
#................................................#
#................................................#
#................................................#
#................................................#
#........................................#.......#
#...........#............................#.......#
#...........#............................#.......#
#...........#............................#.......#
#........................................#.......#
#........................................#.......#
#........................................#.......#
#...........#............................#.......#
#...........#............................#.......#
#...........#....................................#
#................................................#
#................................................#
#................................................#
#..................#######################.......#
#................................................#
#................................................#
#................................................#
##################################################
##################################################